##################
#@#$#...#...#...##
#.#.#.#.#.#.#.#.##
#.#.#.#.#.#.#.#.##
#.#.#.#.#.#.#.#.##
#.#.#.#.#.#.#.#.##
#.#.#.#.#.#.#.#.##
#.#.#.#.#.#.#.#.##
#.#.#.#.#.#.#.#.##
#.#.#.#.#.#.#.#.##
#.#.#.#.#.#.#.#.##
#.#.#.#.#.#.#.#.##
#.#.#.#.#.#.#.#.##
#.#.#.#.#.#.#.#.##
#.#...#...#...#.##
#.#############.##
#...............%#
##################