##################
#.......%.....#..#
#.........#..#...#
#........#..#....#
#....####..#.....#
#....#....#......#
#....#..##.......#
#.....#....#.....#
#......#@.#......#
#.....#....#.....#
######..##..####.#
#..#...#..#......#
#.#.###..........#
#..#....####.....#
#.#..#.#$..#.....#
#..#.#.###.#.....#
#....#.....#.....#
##################