##################
#.......##......##
#.#####.##########
#.....#.###.##.###
#####.#.##.#..#.##
#.....#.###.##.###
#.#####.####.#####
#....##...########
####.#..@..#######
#$...##...#......#
#######.#..#####.#
#.....#.##.......#
#.###.#.####.###.#
#.#%#.#.#..#.#.#.#
#.#...#.#..#.#.#.#
#.#####.#.##.#.#.#
#.......#....#...#
##################